//states and its capitals 

Andhra Pradesh – Hyderabad
Arunachal Pradesh – Itanagar
Assam – Dispur
Bihar – Patna
Chhattisgarh – Raipur
Goa – Panaji
Gujarat – Gandhinagar
Haryana – Chandigarh
Himachal Pradesh – Shimla
Jammu & Kashmir – Srinagar(summer) (Winter : Jammu)
Jharkhand – Ranchi
Karnataka – Bengaluru
Kerala – Thiruvananthapuram
Madhya Pradesh – Bhopal
Maharashtra – Mumbai
Manipur – Imphal
Meghalaya – Shillong
Mizoram – Aizawl
Nagaland – Kohima
Orissa – Bhubaneswar
Punjab – Chandigarh
Rajasthan – Jaipur
Sikkim – Gangtok
Tamil Nadu – Chennai
Telangana – Hyderabad
Tripura – Agartala
Uttar Pradesh – Lucknow
Uttarakhand – Dehradun
West Bengal – Kolkata





// union territories and capitals 

Delhi – New Delhi
Andaman & Nicobar Islands – Port Blair
Chandigarh – Chandigarh
Dadra & Nagar Haveli – Silvasa
Daman & Diu – Daman
Lakshadweep – Kavaratti
Puducherry – Puducherry
